S  +++++++++++++
      +     +  +
****  +  *  +  +
*  *     *     +
*  *******  ++++
*           +  +
****  ****  +  +
*     *        +
*  *  ****  *  +
*  *  *     *   
*************  E